...3.4...
..8...9..
24..6..81
5.......7
...273...
6.......9
83..2..76
..1...4..
...1.6...
