8...7..9.
5.9....7.
..7..8..4
....13...
3.12.65.7
...85....
4..1..2..
.2....7.3
.5..3...6
