.3.....18
..4......
7..2..43.
....947..
1.5...8.9
..258....
.29..1..7
......3..
65.....8.
