....6...3
.7.......
4..7.8.59
5..9..3..
.6..1..2.
..9..3..1
81.4.9..6
.......9.
2...8....
