7...4..6.
....75.9.
...2....3
87.....39
..58.74..
29.....85
3....4...
.5.18....
.2..5...7
