2....74.8
1.....52.
...8...3.
.2..3....
4.3.9.6.5
....8..9.
.7...5...
.45.....3
8.21....4
