6....9..1
.9...3..5
....75.2.
.7.....89
..9...5..
26.....1.
.1.36....
7..8...6.
8..5....4
