5.......9
..45.27..
..2...1..
3...4...7
.6.7.1.8.
2...9...5
..8...6..
..19.45..
7.......4
