..52.14..
49.....85
.........
5...3...7
..7...1..
3...9...2
.........
86.....53
..37.29..
