5...9...4
...6.2...
.8.....2.
76.....82
.2.1.7.5.
41.....79
.5.....6.
...8.9...
8...3...5
