..8...5..
5..4.2..1
1...5...7
.4..8..1.
..6...3..
.3..9..6.
9...7...4
3..2.9..6
..4...1..
