..36.51..
29.....65
.........
4...2...1
.75...42.
9...7...3
.........
51.....87
..93.15..
