3.....8..
...4...31
7..2....5
.9..1....
.5.3.2.7.
....8..1.
9....3..6
42...5...
..1.....8
