..18...5.
........1
7.21....4
....8..3.
26.....98
.9..3....
5....49.2
9........
.7...61..
