.....187.
....7..9.
.5...6..2
.693....1
.........
7....465.
9..1...8.
.2..5....
.742.....
