56...38..
..21.5...
.4.......
...6..2..
2.7...5.9
..9..8...
.......1.
...7.23..
..34...82
