..7..2.14
6..87..5.
.......3.
8..4..2..
.........
..1..6..7
.4.......
.2..18..5
98.2..3..
