.83...2.5
....8....
..4..9...
8..2...56
....7....
52...4..1
...1..7..
....9....
6.8...49.
