.73......
...7.1.9.
9..8...63
........5
...947...
8........
21...3..8
.6.2.8...
......57.
