....1....
37....8..
..943....
7....231.
..4...9..
.169....4
....741..
..1....26
....2....
