...5....6
26...95.3
..7......
3....51..
...8.1...
..87....9
......7..
5.94...12
4....6...
