2......7.
.....9..5
1.86...4.
98....5..
....4....
..2....63
.5...74.8
6..9.....
.4......2
