9...6...5
.....973.
....3..6.
.2.7.....
.73...14.
.....1.5.
.9..5....
.824.....
5...9...2
