....9....
.587....1
.4...3...
.1.6..8.4
....1....
9.3..5.2.
...8...5.
3....798.
....5....
