...6...53
........6
.21..8...
..4...51.
2.......8
.13...2..
...2..79.
8........
94...7...
