...1...98
9..5.....
.8....4..
...68...1
..9...3..
1...72...
..2....3.
.....7..2
85...9...
