7.4..6...
.95......
...3..1..
1...7..5.
.8.....3.
.5..6...4
..2..7...
......92.
...9..8.5
