.5...31..
2.....4..
.....1..6
....6.8.1
.9.....5.
3.8.2....
7..8.....
..6.....7
..41...2.
