.....34..
9..2.....
..2.9...3
...3...4.
43.....79
.5...1...
7...1.8..
.....6..5
..19.....
