....9..68
......5..
2.7.4....
81...5...
.6.....3.
...1...42
....2.9.7
..6......
38..7....
