.....875.
4........
....1..86
.....12.9
5.......8
1.37.....
37..9....
........5
.423.....
