..3...5..
1...6...8
..21.79..
.9..7..4.
3.......1
.4..5..3.
..96.24..
7...9...5
..8...6..
