..76.49..
6.......8
...173...
85.....23
.........
79.....64
...419...
4.......6
..98.52..
