.1.....37
67..5....
.....9...
5......83
..43.25..
96......2
...1.....
....3..21
14.....5.
