.9......7
..72...4.
....3.1..
3214.....
.8.....3.
.....7852
..4.7....
.5...89..
9......8.
