19..4..35
...29....
..4.7....
...3...41
7.......2
81...2...
....3.2..
....26...
92..8..67
