...3...78
3........
.8..7.9..
....9164.
.........
.5362....
..1.4..8.
........6
49...2...
