.4.8..3..
87..5..9.
........5
.8..3...6
..1...4..
2...7..5.
3........
.6..8..19
..4..1.8.
