.8...2..4
1.2.4..7.
.3..972..
6..3.....
..4...5..
.....4..1
..368..5.
.9..7.3.8
8..2...9.
