.74..2.5.
...5...78
5..1.....
.253..8..
.........
..1..642.
.....7..4
86...3...
.1.2..68.
