....5..8.
.1798...2
..57.3...
..1...4..
67.....31
..3...5..
...8.27..
9...4721.
.5..6....
