..4..7...
.......9.
57..86...
.4.....36
.3.7.8.2.
71.....8.
...92..61
.6.......
...3..2..
