....258..
.5.....71
..8......
.9....6.5
7..1.4..9
3.1....8.
......2..
51.....6.
..324....
