.5...43..
3..9..4..
41.......
.3..72..6
....5....
2..89..7.
.......28
..6..5..7
..76...4.
