.9.....3.
..6.87...
54..2...9
1..4.....
..3...1..
.....1..5
3...9..12
...86.4..
.8.....7.
