..4..679.
.....25..
5..1.....
....672.8
..7...9..
2.148....
.....8..3
..96.....
.125..6..
