....86...
6.2......
..7..529.
8..4.....
3...6...5
.....7..2
.356..7..
......8.1
...91....
