.....7.5.
9....8..2
.7...246.
........5
.51...74.
4........
.345...2.
7..3....6
.1.6.....
