.48...97.
....1....
6..3.4..5
..3...1..
.8..9..4.
..4...7..
8..2.9..1
....5....
.72...89.
