8..3.1..2
.6..4..7.
4.......3
..5...9..
1...3...5
..8...3..
6.......4
.2..1..9.
5..7.2..6
