..4...9..
36..2..58
7...6...2
...6.1...
.3.....1.
...7.2...
5...1...3
24..5..97
..9...8..
