.........
...217...
.74...89.
..59.84..
.2.....6.
..95.43..
.83...27.
...386...
.........
