...3.9...
61.....59
..7...2..
.7..9..6.
2...8...7
.9..6..4.
..3...4..
58.....36
...2.6...
