37.....58
...8.5...
4...1...6
..2...1..
...2.4...
..3...7..
9...5...4
...9.7...
25.....31
