.6.....8.
...349...
3.......4
..45.38..
62.....37
..16.29..
9.......8
...158...
.1.....7.
