4.......9
.9..8..6.
.81...52.
...231...
..38.62..
...475...
.56...41.
.4..1..3.
1.......8
