...8.2...
29..7..13
.8.....7.
.54...12.
1.......7
.79...68.
.4.....6.
72..6..35
...4.3...
