41.....93
3...9...7
...6.3...
7...3...4
..8...3..
9...6...1
...2.1...
1...7...2
57.....68
