..6...2..
...6.1...
.8..3..7.
.47...12.
.3.7.6.8.
.28...35.
.7..5..6.
...3.9...
..2...4..
