....9....
5..1.8..9
94.....76
..7...3..
..39275..
..5...6..
35.....62
1..2.6..4
....1....
