8.......4
..5...7..
...723...
.9.2.7.8.
4.......2
.1.9.8.4.
...534...
..9...1..
7.......5
