.6.....4.
..48.76..
7...3...5
..5...4..
.2.1.6.9.
..9...2..
1...2...4
..37.51..
.9.....6.
