.7..1..6.
...692...
8.......1
..5...8..
.891.354.
..1...3..
6.......3
...489...
.4..2..9.
