17.....95
...6.1...
..5...3..
5...8...6
9.8...2.7
3...1...4
..6...7..
...9.4...
42.....61
