..1...9..
6...4...3
2..3.7..5
.2.....3.
..51.27..
.9.....8.
5..4.1..8
8...6...2
..4...6..
