..2...1..
6...2...9
7.......8
.3.9.1.4.
..8.5.9..
.9.7.3.5.
8.......2
9...7...3
..4...6..
