.........
14..7..39
..73.65..
...752...
57.....62
...964...
..35.86..
86..3..21
.........
