..9...2..
..8...3..
3..9.2..6
.4..9..2.
.1.2.3.7.
.6..1..5.
7..1.5..8
..6...5..
..4...9..
