....9....
...865...
.51...26.
463...721
.........
928...356
.36...51.
...624...
....1....
