3.......5
.6..3..9.
...5.7...
..54623..
.4.....1.
..28915..
...6.9...
.9..1..4.
1.......8
