.45.3.27.
1...7...4
..9...6..
.9.....5.
...1.4...
.3.....4.
..2...7..
6...9...1
.17.5.92.
