...26..35
9.....41.
..75.....
....3.5.6
.........
8.1.5....
.....31..
.16.....9
54..12...
