.7...2..3
...3..7..
...16.58.
3...2...6
..8...9..
6...7...5
.42.31...
..1..6...
5..4...1.
