...3...18
..65.....
4....8...
..2.5.1..
8.1...3.2
..9.8.4..
...2....1
.....69..
69...7...
