.3.....56
5...79...
...2..7..
....8...1
2.7...4.8
9...2....
..4..7...
...63...4
16.....3.
