1..3....5
..5....46
..7.5..1.
....387..
.........
..812....
.9..7.1..
34....2..
8....2..4
