....5.6..
75...34..
.4...92..
.....294.
...645...
.829.....
..45...2.
..31...96
..1.3....
