..619....
..92...3.
..7...6.5
4..6.....
2.......4
.....3..8
3.2...1..
.9...24..
....872..
