2..68..3.
78...2...
..5...82.
..64..2..
.1.....7.
..7..36..
.59...3..
...9...85
.6..25..4
