...1..8..
.6......9
1.4.3....
2..85....
.95...41.
....14..7
....4.6.2
8......9.
..3..2...
