2386.....
...83....
5...19...
8....3.72
..7...1..
42.1....9
...35...4
....68...
.....1937
