6.....78.
.2.....9.
...1.35..
...4.....
1..395..6
.....1...
..39.7...
.7.....2.
.95.....3
