2...9..7.
...2...85
.45......
..653.149
.........
791.425..
......79.
67...9...
.5..8...4
