..6.....5
8...46..2
.......13
.9.6.8.7.
.........
.1.9.7.3.
98.......
7..81...9
4.....5..
