.6..5..94
94.......
...2....1
.5..3....
.23...46.
....8..5.
8....7...
.......75
57..4..8.
