.....81..
.5....6..
137......
.....3.8.
.7.192.6.
.4.7.....
......835
..1....2.
..94.....
