...5..2..
.2..91..5
3...4..69
5.3......
..9.6.4..
......3.8
17..8...6
4..95..7.
..6..7...
