.....53.6
.......1.
..1368...
.4...976.
5.......3
.321...5.
...2975..
.2.......
3.94.....
