.....25..
.3.47.8..
.......39
....2..68
...8.7...
54..9....
98.......
..4.68.7.
..61.....
