.24.....7
..6.9....
8..52..1.
......35.
...851...
.42......
.1..75..4
....3.6..
3.....17.
