....3....
5...416..
7..5...89
.3.2..9.4
..54.92..
4.9..3.5.
16...2..8
..415...2
....6....
