.4...1.87
...2.....
1...5....
.32...4..
.8..6..7.
..4...86.
....9...3
.....8...
37.6...5.
