..1....6.
...5.....
.2.84...9
1..3..9..
8..2.1..4
..9..4..1
6...27.8.
.....8...
.7....3..
