..1..8...
67..9....
5..1.7.2.
8..7..1..
.9.....6.
..3..6..5
.5.9.1..3
....3..19
...8..7..
