1.9.....5
....4....
83...546.
.....2798
.........
5834.....
.743...12
....9....
2.....8.4
