8.3..4..9
.....7...
29......1
1....58..
...7.3...
..74....5
3......68
...2.....
5..6..9.3
