8.3.5..7.
4....9...
.....3..1
.9....73.
....2....
.28....9.
1..5.....
...8....6
.6..7.2.3
