...4.....
.5.8.3.2.
..2...91.
...9..8..
3.......6
..1..6...
.36...4..
.4.1.8.9.
.....2...
