..2.8..54
.4..527..
6......82
.....7...
9...4...5
...5.....
31......8
..487..6.
82..1.4..
