...362...
5.......9
..3...7..
72.6.....
4...9...2
.....1.34
..7...8..
9.......5
...154...
