..2.9..84
..43.....
...4...3.
..8.....9
9..5.1..6
4.....3..
.7...9...
.....59..
61..7.8..
