3..91...5
.........
.9..8..7.
..57..3..
.6..2..9.
..4..35..
.1..4..8.
.........
4...36..1
