...6...9.
.79....2.
..4..1..7
....1.3..
4...9...5
..1.8....
3..5..9..
.2....68.
.8...3...
