.6.47...2
..31..6..
.5..697..
3...84...
.........
...51...8
..794..6.
..6..21..
4...31.2.
