..9...71.
...2.....
.8136..9.
..7.24..8
...1.6...
2..57.4..
.7..9863.
.....2...
.42...8..
