...6...4.
.8...7.6.
..9258..7
.......3.
7..3.4..9
.1.......
2..8135..
.4.9...7.
.3...5...
