.53...8..
.2..18...
.1..9....
.42......
6..4.5..9
......35.
....7..9.
...36..2.
..7...18.
