4...5..7.
..6...9..
2..1..5..
...56....
.7.3.9.6.
....74...
..7..2..9
..3...2..
.9..4...1
