5........
..458....
1..9..35.
.....16.4
.5.....2.
3.96.....
.62..7..8
....684..
........2
