.3..2....
.68..7..9
..9....32
....6354.
....7....
.4159....
15....3..
8..3..67.
....1..9.
