.....431.
3......79
......65.
..8.6....
.6.7.3.9.
....5.4..
.16......
84......1
.975.....
