....37.1.
26..5....
.5......8
.36...7..
...7.1...
..1...62.
3......8.
....7..53
.1.29....
