........9
.68..5.3.
...91..2.
.25......
..3.2.4..
......69.
.3..48...
.7.5..81.
2........
