9......6.
...12....
..5.8...3
..4....2.
.6.752.9.
.1....8..
8...6.1..
....45...
.9......4
