.4....5.8
.6..32...
9........
.213....7
....7....
7....896.
........5
...42..3.
8.5....7.
