...8....9
.3..254..
.4...9.5.
96.....1.
..59.72..
.7.....45
.5.7...3.
..623..9.
1....6...
