..1..5..4
.8.......
....38.5.
36...7...
..7...1..
...8...23
.7.92....
.......7.
5..3..2..
