.8....57.
9...6..2.
5..7...19
3........
...4.1...
........4
84...3..7
.6..2...8
.75....3.
