9...37...
......41.
8.....5.7
..54....6
.1.....8.
3....21..
4.6.....3
.57......
...92...5
