164.....3
.3..5....
7..6.....
...1..2.6
5.......4
3.9..8...
.....4..8
....8..3.
8.....175
