.8.....59
..94.....
25...3...
.26.4...5
.1.9.2.6.
5...1.94.
...6...87
.....92..
67.....9.
