..73...6.
.5......3
....96...
..9.2.3.7
1.......4
3.8.1.5..
...48....
2......5.
.4...21..
