.6..4...5
....35.9.
..19..8..
...5....7
2.5.8.3.4
1....4...
..4..72..
.3.25....
5...6..3.
