....5....
.2.49.68.
93...72..
6..9...3.
.........
.8...3..9
..45...27
.56.19.4.
....7....
