.......98
...64...7
.4..892..
1.....68.
..48.31..
.87.....2
..239..5.
8...52...
91.......
