5......81
...56..2.
....7..6.
.......42
..78.43..
18.......
.7..9....
.2..31...
65......9
