72.......
..9..713.
1....8..9
.1.......
..45912..
.......7.
6..7....8
.952..3..
.......54
