..537..1.
49..1....
.3...6.2.
3...9...1
...8.5...
6...4...8
.6.4...7.
....6..43
.4..396..
