7.......8
....1..96
.1...6..2
..1..7...
..89.35..
...2..9..
9..4...8.
83..5....
1.......9
