.7....23.
..5.987..
.....4..6
82.......
...8.5...
.......87
1..4.....
..812.6..
.53....7.
