.256.879.
..4...3..
....1....
.7.....5.
...569...
.4.....8.
....3....
..2...8..
.817.462.
