..7...2..
.9..1..5.
1...4...3
.4.8.5.7.
.5.....9.
.8.7.3.6.
9...3...5
.7..8..3.
..6...1..
