71.....64
.........
38..7..15
..14.73..
.........
..73.92..
25..6..89
.........
86.....37
