..2...1..
.8..7..5.
6.......9
..95.43..
..59.64..
..81.75..
4.......2
.5..4..7.
..3...6..
