..3...4..
...538...
.9.....2.
.4.7.9.5.
8.......1
.3.8.2.7.
.7.....4.
...153...
..2...8..
