5...4...8
.4..3..5.
..85.12..
.6.....3.
3.......5
.7.....1.
..43.26..
.1..5..8.
7...1...3
