...539...
.9.....7.
4.......3
54.....86
..83.51..
31.....92
7.......8
.5.....6.
...817...
