3...2...6
.........
.18...49.
..27.43..
5..9.3..7
..72.69..
.84...61.
.........
2...3...8
