92.....43
..8...7..
...265...
7..5.1..8
.........
8..4.9..2
...324...
..1...9..
43.....57
