4.......6
7..138..5
..8...1..
.4.5.2.6.
.........
.9.8.6.7.
..9...2..
2..964..8
8.......7
