6.......2
.8..7..9.
..78.94..
.1..2..5.
..4...9..
.7..8..2.
..32.57..
.9..3..8.
7.......5
