......1.3
.1..5....
....437..
......251
..2...6..
683......
..857....
....8..9.
4.9......
