.1.....75
..9...3..
72.1.....
..24.....
.6.....8.
.....97..
.....5.61
..3...2..
47.....5.
