7....92..
.....1...
..24...6.
...5...9.
13.....25
.8...3...
.9...43..
...7.....
..46....7
