....94..2
.....73..
.1....4..
..7....1.
.4.3.2.5.
.3....8..
..8....7.
..19.....
9..16....
