8...2....
.6....19.
....5.3..
.....8..5
2.4...6.1
3..5.....
..8.9....
.79....6.
....6...4
