2...7...3
.63...91.
..1...8..
4...9...1
...4.7...
3...6...9
..8...6..
.39...74.
6...3...5
