9...8....
6.4......
...92..8.
..5....18
...3.1...
31....2..
.3..74...
......5.9
....3...6
