...78....
193......
....6...2
95.......
.67...94.
.......18
7...4....
......853
....39...
