.......2.
..8.2...9
2..4....8
..68...5.
..5...1..
.8...54..
1....3..4
7...1.5..
.2.......
