.9.....6.
.25...78.
...576...
..7.1.8..
..19.45..
..2.5.3..
...129...
.39...15.
.1.....9.
