..6...5..
3.......8
...379...
.39.5.26.
4.......7
.57.9.84.
...614...
7.......4
..5...3..
