....65.2.
.7..8....
49.....15
..3..6...
..4...9..
...7..6..
98.....57
....5..6.
.5.41....
