....2..1.
.158.....
...6...48
29....5..
4.......2
..3....64
35...4...
.....395.
.8..1....
