.2...89..
...9....5
.....34..
19....5..
.5..3..6.
..4....31
..27.....
9....4...
..75...1.
