6...1....
.7...92..
..38.....
....95..7
79.....23
3..78....
.....49..
..82...1.
....6...5
