.7....98.
...23....
5..4.81..
..8.....6
.2.....4.
7.....8..
..13.9..2
....41...
.63....5.
