8..1..9..
..7..3...
...69...5
.3...7...
..2.1.4..
...4...6.
5...64...
...5..2..
..9..2..4
