....17..9
5..8..3..
3......2.
.9......1
.25...64.
6......5.
.1......3
..4..3..5
2..14....
