....4...2
.168....7
8....26..
..2...7.4
5...2...8
6.9...5..
..54....3
4....729.
7...8....
