.65......
...53..8.
.....935.
6.2..7.3.
...9.2...
.8.3..6.4
.146.....
.3..28...
......26.
