.8.....25
.1..5...3
.5.2.94..
....3...9
...127...
5...8....
..85.3.6.
7...4..8.
69.....3.
