.9..41..3
56.2..9..
.2...6...
.83......
...372...
......63.
...8...7.
..6..3.59
2..15..4.
