93......4
...5.....
...48.57.
..68...9.
.9.1.4.5.
.8...62..
.49.13...
.....2...
2......39
