1..8..3..
7...24..6
...5.....
..27..81.
3.......9
.48..36..
.....7...
6..43...7
..9..2..8
