.796.....
....31..2
8........
2.6.1....
3.......5
....5.8.7
........4
6..92....
.....756.
