.4.......
5..8.....
.92.3..57
.7..86..5
....4....
1..27..3.
38..6.14.
.....9..8
.......6.
