......94.
...5896..
.......21
.2.9....5
..43.67..
5....2.3.
27.......
..3465...
.45......
