...6483.5
32....8..
.........
.8..1...9
9.2.8.4.1
7...5..8.
.........
..1....42
6.3492...
