.1.4.....
5789....2
.4..8....
1.......6
..91354..
8.......3
....2..1.
7....1638
.....3.9.
