...8..2..
.4...2...
.8.4...15
8..1...32
.2.9.8.5.
59...7..6
71...4.8.
...5...7.
..5..9...
