.3...5..2
..2.9....
.6....37.
6...89...
9.4...5.6
...56...4
.78....2.
....3.8..
5..7...4.
