..42.71..
.6.....7.
.2..5..4.
7...6...3
...1.2...
8...4...1
.9..1..3.
.8.....6.
..68.35..
