.6.....8.
1...5...2
..89.61..
.3.....4.
8..5.7..3
.1.....5.
..38.27..
9...7...6
.4.....9.
