6..5.7..2
54..3..98
.........
.9..2..6.
...3.5...
.5..9..3.
.........
96..8..54
4..1.2..7
