7...2...3
.........
5..346..2
.5..3..4.
.78...35.
.9..8..6.
2..178..4
.........
4...5...1
