..92.36..
6...4...7
.........
26.....51
1..4.8..3
98.....46
.........
3...1...8
..85.92..
