29..8..34
...6.2...
..7...1..
5.......8
8..7.4..3
9.......7
..5...3..
...2.1...
42..3..91
