..8...1..
2...3...5
...742...
.8.1.5.2.
..5...6..
.1.4.7.3.
...673...
6...1...7
..9...4..
