...1.9...
..17653..
..2...1..
1.......8
.53...71.
4.......2
..5...8..
..78125..
...9.3...
