.1.9.3.6.
.57...39.
3.......8
...146...
.........
...278...
5.......3
.36...97.
.8.6.2.1.
