..63.84..
.5..1..9.
3.......1
.8.....5.
..52.69..
.7.....3.
7.......5
.6..3..1.
..14.98..
