2..813..5
.4..7..3.
.1.....9.
..6...7..
...2.1...
..3...9..
.5.....7.
.3..6..5.
8..457..2
