...621...
1.......3
.5.7.9.6.
.9..6..2.
..7...3..
.1..7..4.
.2.8.6.5.
8.......6
...312...
