..3...6..
.7.....4.
...819...
6...4...2
5..3.8..6
9...6...3
...675...
.5.....9.
..1...8..
