72.....64
....1....
..14.35..
.1.....5.
..27.64..
.9.....8.
..86.92..
....3....
56.....39
