4.......9
2...5...3
..62147..
....8....
.4.9.6.3.
....3....
..38451..
5...9...7
1.......2
