2..1.9..3
.1.....4.
....4....
..1...8..
4.63.27.9
..2...5..
....3....
.5.....9.
9..7.4..2
