.8..6..4.
.2.....7.
...375...
..3...8..
.57.8.92.
..8...6..
...149...
.4.....6.
.7..2..5.
