.4..9..7.
..8...4..
7..2.4..9
3...5...6
..1...9..
6...2...7
4..7.8..2
..9...8..
.2..1..5.
