.........
3..5.8..4
.81...37.
.6..4..8.
..7.9.6..
.9..5..3.
.76...49.
8..9.1..7
.........
