.79...25.
.3.....1.
..14.97..
...928...
.........
...357...
..72.14..
.1.....3.
.64...57.
