61.....29
...321...
....8....
524...697
.........
398...215
....6....
...294...
25.....61
