9...1...2
..59647..
.3.....1.
..86.24..
.........
..93.12..
.4.....9.
..71386..
1...7...8
