..6...2..
.71...93.
...5.4...
.1..4..2.
.3.2.8.5.
.4..6..7.
...6.1...
.27...41.
..8...7..
