.5..1..9.
..3...1..
.4..2..6.
8..967..4
.........
5..138..2
.7..8..4.
..9...5..
.2..7..8.
