.3..4..7.
.2.7.1.5.
..7...2..
..4...3..
.7.4.9.6.
..9...4..
..8...6..
.1.5.7.3.
.6..2..9.
